NO textures/Mona_Lisa.png
SO textures/Wheat_Field.png
WE textures/the_starry_night.png
EA textures/the_tower_of_babel.png

C 0,0,33
F 60,179,110


1111111111111
1000000000001
1000000000001
1000000000001
1000000000001
1000000000001
1001000000001
1000000000001
1000000000001
1000000100001
1000000000001
1000000000001
1000000000001
1000000000001
1000000000001
1000000000001
1000N00000001
1000000000001
1000000000001
1111111111111