
NO                ./textures/the_starry_night.png
WE  ./textures/the_tower_of_babel.png
EA  ./textures/Wheat_Field.png

SO  ./textures/SO.png

C          255,30,0


F 220,100,-0



111111111111111111
100000000001000001
100000000001000001
10111110S001000001
100000000001000001
100000000001000001
100000000001000001
100000000001000001
100000000001000001
100000000001000001
100000000001000001
100000000001000001
100000000001000001
100000000001000001
100000000001000001
100000000001000001
100000000001000001
100000000001000001
100000000001000001
100000000001000001
100000000001000001
100000000001000001
100000000001000001
100000000001000001
111111111111111111
