
SO                ./path_to_the_south_texture
WE ./path_to_the_west_texture
EA ./path_to_the_east_texture

NO ./path_to_the_north_texture

C          255,30,0


F 220,100,-0



111111111111
100000000001
100000000001
101111100001
10000000N001
100000000001
111111111111
