
NO                ./textures/the_starry_night.png
WE  ./textures/the_tower_of_babel.png
EA  ./textures/Wheat_Field.png

SO  ./textures/SO.png

C         180,255,255


F 220,100,0



111111111111111111
100000000001000001
100000000001000001
10111110S001000001
100000000001000001
100000000001000001
100000000001000001
100000000001000001
100000000001000001
100000000001000001
1000000000010011111111
100000000001001 100001
1000000000010011111111
100000000001000001
100000000001000001
100000000001000001
100000000001000001
100000000001000001
100000000001000001
100000000001000001
100000000001000001
100000000001000001
100000000001000001
100000000001000001
111111111111111111

