
NO                ./textures/NO.png
WE  ./textures/WE.png
EA  ./textures/EA.png

SO  ./textures/SO.png

C          255,30,0


F 220,100,-0



111111111111111111
100000000001000001
100000000001000001
10111110E001000001
100000000001000001
100000000001000001
111111111111111111
