NO textures/Mona_Lisa.png
SO textures/Wheat_Field.png
WE textures/the_starry_night.png
EA textures/the_tower_of_babel.png

C 225,30,0
F 220,100,0

  1111
11N11111111
111111111