
NO                ./textures/kilimanjaro.png
WE  ./textures/antelope_canyon.png
EA  ./textures/sagano_bamboo_forest.png

SO ./textures/torres_del_paine_small.png

C         180,255,255


F 180,100,0



111111111111111111
100000000001000001
100000000001000001
10111110S001000001
100000000001000001
100000000001000001
100000000001000001
100000000001000001
100000000001000001
100000000001000001
1000100000010011111111
100000000001000000011
1000000000010011111111
100000000001000001
100000000001000001
100000000001000001
100000000001000001
100000000001000001
100000000001000001
100000000001000001
100000000001000001
100000000001000001
100000000001000001
100000000001000001
111111111111111111

